Alanine_aminotransferase	@@@@@@/projects/biomarkers/sumstats_diverse/white_british/plink_imputed/filtered/INT_Alanine_aminotransferase_all.glm.linear.filtered.maf001.info03.tsv.gz
Albumin	@@@@@@/projects/biomarkers/sumstats_diverse/white_british/plink_imputed/filtered/INT_Albumin_all.glm.linear.filtered.maf001.info03.tsv
Alkaline_phosphatase	@@@@@@/projects/biomarkers/sumstats_diverse/white_british/plink_imputed/filtered/INT_Alkaline_phosphatase_all.glm.linear.filtered.maf001.info03.tsv
Apolipoprotein_A	@@@@@@/projects/biomarkers/sumstats_diverse/white_british/plink_imputed/filtered/INT_Apolipoprotein_A_all.glm.linear.filtered.maf001.info03.tsv
Apolipoprotein_B_adjstatins	@@@@@@/projects/biomarkers/sumstats_diverse/white_british/plink_imputed/filtered/INT_Apolipoprotein_B_adjstatins_all.glm.linear.filtered.maf001.info03.tsv
Apolipoprotein_B	@@@@@@/projects/biomarkers/sumstats_diverse/white_british/plink_imputed/filtered/INT_Apolipoprotein_B_all.glm.linear.filtered.maf001.info03.tsv
Aspartate_aminotransferase	@@@@@@/projects/biomarkers/sumstats_diverse/white_british/plink_imputed/filtered/INT_Aspartate_aminotransferase_all.glm.linear.filtered.maf001.info03.tsv
Calcium	@@@@@@/projects/biomarkers/sumstats_diverse/white_british/plink_imputed/filtered/INT_Calcium_all.glm.linear.filtered.maf001.info03.tsv
Cholesterol_adjstatins	@@@@@@/projects/biomarkers/sumstats_diverse/white_british/plink_imputed/filtered/INT_Cholesterol_adjstatins_all.glm.linear.filtered.maf001.info03.tsv
Cholesterol	@@@@@@/projects/biomarkers/sumstats_diverse/white_british/plink_imputed/filtered/INT_Cholesterol_all.glm.linear.filtered.maf001.info03.tsv
C_reactive_protein	@@@@@@/projects/biomarkers/sumstats_diverse/white_british/plink_imputed/filtered/INT_C_reactive_protein_all.glm.linear.filtered.maf001.info03.tsv
Creatinine_in_urine	@@@@@@/projects/biomarkers/sumstats_diverse/white_british/plink_imputed/filtered/INT_Creatinine_in_urine_all.glm.linear.filtered.maf001.info03.tsv
Creatinine	@@@@@@/projects/biomarkers/sumstats_diverse/white_british/plink_imputed/filtered/INT_Creatinine_all.glm.linear.filtered.maf001.info03.tsv
Cystatin_C	@@@@@@/projects/biomarkers/sumstats_diverse/white_british/plink_imputed/filtered/INT_Cystatin_C_all.glm.linear.filtered.maf001.info03.tsv
Direct_bilirubin	@@@@@@/projects/biomarkers/sumstats_diverse/white_british/plink_imputed/filtered/INT_Direct_bilirubin_all.glm.linear.filtered.maf001.info03.tsv
eGFR	@@@@@@/projects/biomarkers/sumstats_diverse/white_british/plink_imputed/filtered/INT_eGFR_all.glm.linear.filtered.maf001.info03.tsv
Fasting_glucose	@@@@@@/projects/biomarkers/sumstats_diverse/white_british/plink_imputed/filtered/INT_Fasting_glucose_all.glm.linear.filtered.maf001.info03.tsv
Gamma_glutamyltransferase	@@@@@@/projects/biomarkers/sumstats_diverse/white_british/plink_imputed/filtered/INT_Gamma_glutamyltransferase_all.glm.linear.filtered.maf001.info03.tsv
Glucose	@@@@@@/projects/biomarkers/sumstats_diverse/white_british/plink_imputed/filtered/INT_Glucose_all.glm.linear.filtered.maf001.info03.tsv
Glycated_haemoglobin_HbA1c	@@@@@@/projects/biomarkers/sumstats_diverse/white_british/plink_imputed/filtered/INT_Glycated_haemoglobin_HbA1c_all.glm.linear.filtered.maf001.info03.tsv
HDL_cholesterol	@@@@@@/projects/biomarkers/sumstats_diverse/white_british/plink_imputed/filtered/INT_HDL_cholesterol_all.glm.linear.filtered.maf001.info03.tsv
IGF_1	@@@@@@/projects/biomarkers/sumstats_diverse/white_british/plink_imputed/filtered/INT_IGF_1_all.glm.linear.filtered.maf001.info03.tsv
LDL_direct_adjstatins	@@@@@@/projects/biomarkers/sumstats_diverse/white_british/plink_imputed/filtered/INT_LDL_direct_adjstatins_all.glm.linear.filtered.maf001.info03.tsv
LDL_direct	@@@@@@/projects/biomarkers/sumstats_diverse/white_british/plink_imputed/filtered/INT_LDL_direct_all.glm.linear.filtered.maf001.info03.tsv
Lipoprotein_A	@@@@@@/projects/biomarkers/sumstats_diverse/white_british/plink_imputed/filtered/INT_Lipoprotein_A_all.glm.linear.filtered.maf001.info03.tsv
Microalbumin_in_urine	@@@@@@/projects/biomarkers/sumstats_diverse/white_british/plink_imputed/filtered/INT_Microalbumin_in_urine_all.glm.linear.filtered.maf001.info03.tsv
Non_albumin_protein	@@@@@@/projects/biomarkers/sumstats_diverse/white_british/plink_imputed/filtered/INT_Non_albumin_protein_all.glm.linear.filtered.maf001.info03.tsv
Oestradiol	@@@@@@/projects/biomarkers/sumstats_diverse/white_british/plink_imputed/filtered/INT_Oestradiol_all.glm.linear.filtered.maf001.info03.tsv
Phosphate	@@@@@@/projects/biomarkers/sumstats_diverse/white_british/plink_imputed/filtered/INT_Phosphate_all.glm.linear.filtered.maf001.info03.tsv
Potassium_in_urine	@@@@@@/projects/biomarkers/sumstats_diverse/white_british/plink_imputed/filtered/INT_Potassium_in_urine_all.glm.linear.filtered.maf001.info03.tsv
Rheumatoid_factor	@@@@@@/projects/biomarkers/sumstats_diverse/white_british/plink_imputed/filtered/INT_Rheumatoid_factor_all.glm.linear.filtered.maf001.info03.tsv
SHBG	@@@@@@/projects/biomarkers/sumstats_diverse/white_british/plink_imputed/filtered/INT_SHBG_all.glm.linear.filtered.maf001.info03.tsv
Sodium_in_urine	@@@@@@/projects/biomarkers/sumstats_diverse/white_british/plink_imputed/filtered/INT_Sodium_in_urine_all.glm.linear.filtered.maf001.info03.tsv
Testosterone	@@@@@@/projects/biomarkers/sumstats_diverse/white_british/plink_imputed/filtered/INT_Testosterone_all.glm.linear.filtered.maf001.info03.tsv
Total_bilirubin	@@@@@@/projects/biomarkers/sumstats_diverse/white_british/plink_imputed/filtered/INT_Total_bilirubin_all.glm.linear.filtered.maf001.info03.tsv
Total_protein	@@@@@@/projects/biomarkers/sumstats_diverse/white_british/plink_imputed/filtered/INT_Total_protein_all.glm.linear.filtered.maf001.info03.tsv
Triglycerides	@@@@@@/projects/biomarkers/sumstats_diverse/white_british/plink_imputed/filtered/INT_Triglycerides_all.glm.linear.filtered.maf001.info03.tsv
Urate	@@@@@@/projects/biomarkers/sumstats_diverse/white_british/plink_imputed/filtered/INT_Urate_all.glm.linear.filtered.maf001.info03.tsv
Urea	@@@@@@/projects/biomarkers/sumstats_diverse/white_british/plink_imputed/filtered/INT_Urea_all.glm.linear.filtered.maf001.info03.tsv
Vitamin_D	@@@@@@/projects/biomarkers/sumstats_diverse/white_british/plink_imputed/filtered/INT_Vitamin_D_all.glm.linear.filtered.maf001.info03.tsv.gz
